#####################
#                   #
#     1  CARTE_A    #
#                   #
#     2  CARTE_B    #
# P                 #
#     3  CARTE_C    #
#                   #
#     4  CARTE_D    #
#                   #
#####################