##################
#        #      O#
#        #   O   #
#  XO  ###       #
#           X  X #
# OXP XO         #
##################