################
#              #
#              #
#    P         #
#              #
#              #
#   X O#       #
#      #       #
################